TTTTTTTTTTTTTT
T            T
T    R       T
T    R       T
T            T
T            T
TR           T
T            T
TTTTTTTTTTTTTT